CACCCTTA
CCGCCCAT
CTACCATC
TTCCTCCT
CCATCCTT
GGTTCTTG
TTACCAAC
CTTCCCAC
GCCTCCTC
TCCACCTC
CTCCTCCA
GGTTCCCT
TTTGGTTG
TGGTTGGG
GTTCTTTC
TTTCTTCC
TTCCATTC
GGTTGGTT
ATTTCCAC
CACCACCG
CAACCCAA
TCTTTCCC
CATCCCTT
CGCCATTC
CATTTCCA
ATCTTCCG
GGTTTCCC
GTTTCCCG
AGGTTCCT
CCACCGCC
TCCATTCT
GCCGCCCT
CCATTCCC
CGCCAAAC
CTTACCTC
TTCTCTTG
CATCCTTG
CCATTTCT
TGGGTTAC
AAACCCAC
AAACCTTA
TTCTTTGG
CATTCTAC
TCTTACCT
ATTCCTCC
CTTCTCTT
TACCATCT
CTCTTTGA
CTTTCCGC
GGGTTCTC
TTACCTTA
TTCTCCAC
CCTCTTCT
TCTACCCA
GCCAAACC
CACCTCTC
CGCCCACC
CACCCAAC
GTTCCACC
TTTCCAAA
CTCCCTTG
CACCATCC
CTTCCTCT
ACCCTTCT
GGTTCCGC
TTCCCTTT
AGTTGGGA
CCCACCGC
AAACCGCC
ATTCTCCT
CCTCCTCC
CCTTGGGT
CGCCATCT
TCTCTTTG
ATTCCCTT
CGCCCAAA
CCTACCAA
TTCTACCT
CTTCCCTA
CTCTTTCC
CATTGGTT
CTCTCCCT
ATCTCTTA
GCCGCCGC
GCCTACCG
ATCTCCTT
ATCCCTTC
ATTACCCA
TTACCCAA
CTTGGGTT
GCCTTCTT
CTACCTTT
CTCCTTTA
TGGTTTGA
CAACCTAC
AGTTACCT
TTCCTTGA
AGTTTCTT
CTTACCAT
ATTCCTTG
AGTTCTCT
TCCATCCA
GGTTCTAC
CTCCATTT
ACCTCCAT
CATTCCAT
CCATTGGT
GTTTCTTC
GCCATCCT
ACCTACCC
TTACCCGC
GCCTCCAA
TCCATTTA
TACCCACC
CTTCTTAC
GTTTCCTA
CCCTACCA
TCTTCCCG
CCAACCAT
CCGCCCGC
CTCTCTAC
CTCCCTCC
TCTTGGGA
AGTTTGGT
AACCTTTG
ATCTCTCC
TCCGCCTT
CTCCTTCT
CTTCTTTG
ACCTTACC
GCCTTCCA
CCTCTTTC
CATCCACC
ACCTTCTC
GCCCTTTC
CCCATTCC
CGCCTCCC
AGGGTTGG
CATTACCC
CCCTTGGG
AGTTTCCA
TACCAAAC
CCATCTTC
TACCCTTG
TCTTCCTT
CTTTCCCA
ATCCATTG
TCCTCTTC
TGGTTCTT
CTCCTACC
GCCACCAC
GCCCTCCC
TCTACCAT
TACCTTTA
ACCATCTT
ACCGCCTA
TACCTCCC
CCGCCATC
CAACCTCT
ACCTTCCT
TCTCTTGA
TCTCCTTT
TGGGTTTG
ACCACCCA
ACCCTCCA
TCCTCCCT
ATCCTTCC
TTTACCAA
TCTTTGGT
TCCAACCG
TCCTCCTA
CATCTCCT
GCCCATTG
AACCCTCT
TTCTTCTT
GCCTCTTA
CCTCCATT
AGGGTTCC
TTCTTCCA
CCACCTTA
CTTTCTTA
CTCTACCG
ACCCATTC
ATCTCCGC
TTTCTCTA
GCCCGCCT
AACCTCCT
ATTGGTTT
CCACCCAC
ACCCTTGA
CCCTCTCC
ACCATTTG
