AACGTCCA
GCGAGTAT
AGCGCCTT
AGTAGCTG
GGAAGGCT
GCTTTCAT
TGCGAACA
TATCACGG
GTACCACT
AGCTTGGA
CACACCCT
GTACAATC
CCACACTT
ACAAAGAC
CGAGGAGA
AATGGGTA
GGTAAACC
ACAGGAGT
TGCATGTG
GCCCTTAG
CCAAGTCC
CAGAGTGG
TTTAAGGC
ACCACCGT
TCTGTTTG
CGACTTCG
CATACGAC
GAAAGACA
CCTTAGCC
GTGGATTA
CACATAAC
ACTCAGAT
TACTACCA
CATCTCGA
CGGAAAGC
GTGCAAAT
AGGTACGG
CCTGGTCA
GGTGGAAA
TCTTGATG
ATCGAAGT
CGCCAAAC
GAGAACAA
AACTTGCC
TCCACGCA
ACGATCGG
GTTCTTGA
CGACCCAA
GACTTAGA
TATATCCG
TGCAATCT
ATCCGGGT
CACTGTCC
AGTGAGAC
AACCGTAG
CGTATGAA
TAAGCGGT
AAACGCTT
CACTAAGT
CAAGAGCA
CTGTCGTA
TCAACGTT
TGTGGACG
CATGGCAC
AAAGAGGC
AAGGCAGA
ACGCAACC
CGTTATCA
GCGTCATG
GAGTCACA
AGTCCTTT
ATTCTGGC
TGCGTAAT
TTACAGAC
GTTGAGTG
GAAGGATG
GAAGACGT
GGTGCTGT
CATTTGGG
GTCTCTAA
CAGCGAAC
ATGTCCCT
TCACATTG
CTTTCCTC
CTGGCTAT
CTGCAGTC
ACTGCACA
TAGGGTTC
ACTACAAC
GTACGTTT
CAATACTG
TTCCCGAG
GCAGGTTA
AATGGTCC
TTTCCCAA
TGAAACTG
CCCACAGA
AAACACAG
GCACACAC
GAGTGGGT
TAAGATGG
TTTGGGTC
GGGTCTAG
ACGACTAA
AGTTGTAC
TTTGGCCA
ACCGACTC
GTAAGCTC
TGGGTTGA
CAGAGATA
ATAGGCCT
CCCATGCT
GGTATTCG
AATGCGAT
TCTCCAGA
AATCTTGG
GAATAAGG
GCTAGATT
TTCACGTC
TCGCGTAC
TTGTTAGG
AGCGCAAA
TGGACGGT
CCAACAAT
TTGAGGCG
TTGGCGGA
CTACTATG
AGCCTCTG
GTCTACCT
TGCTAAAG
TAACTGGC
CCGAACGT
GGGCAAGA
GACGATAC
GGTTCGCA
ACCTAATG
CTCAGACC
CCATGGGT
TCAGCCAT
TAGTCTGT
AACTTCGT
GTTACCGC
TTCCAACG
CTTATAGC
ATGCTCCA
TTCGCTGT
GTCCTAGG
CATACCGG
ACGCGTCA
GACACTGA
GCAATCAA
GCACGGAT
GTAGTGTC
TGAGCGTA
ATGGTAGC
CTATCGAT
CGGTGAAG
TACCTTGA
CGGACTCT
CCCTTATT
GTATACGA
GGGAGTTC
AATCGGCG
GCCTCCTT
TGACTCTC
CCACGGTA
TCTGTAGC
TGCTGGTA
GTATTGCT
TAGACGAG
GCTACGAG
AATCCCAC
CGAACATA
ACTCTCCT
TGCCTGAC
CAAGCAAG
TGTGGCTT
GACCAGAA
TTGTACCC
GCTGCTTC
CGATGTTT
TGTTCGGG
GGATCAGA
CGTGCAAC
TTGAACAG
CTATCCCA
CGTTGGCT
AGATTGAG
TCGCAGGA
CACCTATA
CCGTCTGA
GCCAAAGG
